########################################
#      ........               #        #
#     #######                 #        #
####       ###########        #        #
#  #          #               #####    #
#  #          #########     .     #    #
#  #      .   #  .    #           #    #
# ######  .       .   #     .     ######
#      #  .   #   .   #        .       #
#         .   #                        #
########################################